1111111111
1000000001
1P00C00001
1000C00001
1000000001
1000E00001
1111111111